# Level Set: #2
# Level: #01
# Name: Gradient
HHHHHHHHHHHHHHHHHHH
NNNNNNNNNNNNNNNNNNN
WWWWWWWWWWWWWWWWWWW
HHHHHHHHHHHHHHHHHHH
NNNNNNNNNNNNNNNNNNN
NNPNNNNNSSNNNNNNPNN
WWWWWWWSSSSWWWWWWWW
HHHHHHHHSSHHHHHHHHH
NNNNNNNNNNNNNNNNNNN
WWWWWWWWWWWWWWWWWWW
HHHHHHHHHHHHHHHHHHH
NNNNNNNNNNNNNNNNNNN
WWWWWWWWWWWWWWWWWWW
