# Level Set: #2
# Level: #05
# Name: The Box
<HHHHHHHHHHHHHHHHHHHHHHHHHHHH
<HWWWWWWWWWWWWWWWWWWWWWWWWWWH
<HWWWWWWWWWWWWWWWWWWWWWWWWWWH
<HWWWWWWWWWWWWWWWWWWWWWWWWWWH
<HWWWWWWWWWWWWWWWWWWWWWWWWWWH
<HWWWWWWWWWWWWWWWWWWWWWWWWWWH
<HWWWWWWWWWWWWPWWWWWWWWWWWWWH
<HWWWWWWWWWPWWWWWPWWWWWWWWWWH
<HWWWWWWWWWWWWPWWWWWWWWWWWWWH
<HWWWWWWWWWWWWWWWWWWWWWWWWWWH
<HWWWWWWWWWWWWWWWWWWWWWWWWWWH
<HWWWWWWWWWWWWWWWWWWWWWWWWWWH
<HWWWWWWWWWWWWWWWWWWWWWWWWWWH
<HWWWWWWWWWWWWWWWWWWWWWWWWWWH
<HHHHHHHHHHHHHHHHHHHHHHHHHHHH
