# Level Set: #1
# Level: #05
# Name: Helix
>>NNSSNNSSNNSSNNSSNNSSNNSSNNSS
<<NXNXNXNXNXNXNXNXNXNXNXNXNXNX
>>NXNXNXNXNXNXNXNXNXNXNXNXNXNX
<<NXNXNXNXNXNXNXNXNXNXNXNXNXNX
>>NNSSNNSSNNSSNNSSNNSSNNSSNNSS
XXXXXXXXXXXXXXXXXXXXXXXXXXXX
<(WWWPWWWPWWWPWWW)PWWWPWWWPWWW
XXXXXXXXXXXXXXXXXXXXXXXXXXXX
>(WWWPWWWPWWWPWWW)PWWWPWWWPWWW
XXXXXXXXXXXXXXXXXXXXXXXXXXXX
>>NNSSNNSSNNSSNNSSNNSSNNSSNNSS
<<NXNXNXNXNXNXNXNXNXNXNXNXNXNX
>>NXNXNXNXNXNXNXNXNXNXNXNXNXNX
<<NXNXNXNXNXNXNXNXNXNXNXNXNXNX
>>NNWWNNWWNNWWNNWWNNWWNNWWNNWW
