# Level Set: #1
# Level: #09
# Name: Danger Zone
SNNNNNNSNNNNNNSNNNNNNSNNNNNNS
SWWWWWWSWWWWWWSWWWWWWSWWWWWWS
SWWWWWWSWWWWWWSWWWWWWSWWWWWWS
SWWWWWWSWWWWWWSWWWWWWSWWWWWWS
SWWWWWWSWWWWWWSWWWWWWSWWWWWWS
SWWWWWWSWWWWWWSWWWWWWSWWWWWWS
SWWWWWWSWWWWWWSWWWWWWSWWWWWWS
SWWPPWWSWWPPWWSWWPPWWSWWPPWWS
SWWWWWWSWWWWWWSWWWWWWSWWWWWWS
SWWWWWWSWWWWWWSWWWWWWSWWWWWWS
SWWWWWWSWWWWWWSWWWWWWSWWWWWWS
SWWWWWWSWWWWWWSWWWWWWSWWWWWWS
SWWWWWWSWWWWWWSWWWWWWSWWWWWWS
SWWWWWWSWWWWWWSWWWWWWSWWWWWWS
SNNNNNNSNNNNNNSNNNNNNSNNNNNNS
