# Level Set: 1
# Level: #07
# Name: The Wall
HHHHHHHHHHHHHHHHHHHHHHHHHHH
>PWPWPWPWPWPWPWPWPWPWPWPWPWP
NNNNNNNNNNNNNNNNNNNNNNNNNNN
NNNNNNNNNNNNNNNNNNNNNNNNNNN
WWWWWWWWW WWWW WWWWWWWWWWWW
WWWWWWW WWWWWWWW WWWWWWWWWW
WWWWWW WWWSSSSSWWW WWWWWWWW
WWWWWWW WWWWWWWWW WWWWWWWWW
WWWWWWWW WWWWWWW WWWWWWWWWW
NNNNNNNNNNNNNNNNNNNNNNNNNNN
<PWPWPWPWPWPWPWPWPWPWPWPWPWP
NNNNNNNNNNNNNNNNNNNNNNNNNNN
NNNNNNNNNNNNNNNNNNNNNNNNNNN
NNNNNNNNNNNNNNNNNNNNNNNNNNN
SHSHSHSHSHSHSHSHSHSHSHSHSHS