# Level Set: #1
# Level: #10
# Name: X
<SWWWWWWWWWWWWWWWWWWWWWWWWWS
<WWSWWWWWWWWWWWPWWWWWWWWWWSW
<WWWWSWWWWWWWWWWWWWWWWWWWSWW
<WWWWWWSWWWWWWWWWWWWWWWSWWWW
<WWWWWWWWSWWWWWWWWWWWSWWWWWW
<WWWWWWWWWWSWWWWWWWSWWWWWWWW
<WWWWWWWWWWWWSWWWSWWWWWWWWWW
<WWWPWWWWWWWWWWSWWWWWWWWPWWW
<WWWWWWWWWWWWSWWWSWWWWWWWWWW
<WWWWWWWWWWSWWWWWWWSWWWWWWWW
<WWWWWWWWSWWWWWWWWWWSWWWWWWW
<WWWWWWSWWWWWWWWWWWWWWSWWWWW
<WWWWSWWWWWWWWWWWWWWWWWWSWWW
<WWSWWWWWWWWWWWPWWWWWWWWWWSW
<SWWWWWWWWWWWWWWWWWWWWWWWWWS
