# Level Set: #1
# Level: #08
# Name: The Diamond
<WWWWWWWWWWWWWPWWWWWWWWWWWWW
<WWWWWWWWWWWWHNHWWWWWWWWWWWW
<WWWWWWWWWWWHNNNHWWWWWWWWWWW
<WWWWWWWWWWHNNNNNHWWWWWWWWWW
<WWWPWWWWWHNNNNNNNHWWWWWPWWW
<WWWWWWWWHNNNNNNNNNHWWWWWWWW
<WWWWWWWHNNNNNNNNNNNHWWWWWWW
<WWWWWWPHNNNNNNNNNNNHPWWWWWW
<WWWWWWWHNNNNNNNNNNNHWWWWWWW
<WWWWWWWWHNNNNNNNNNHWWWWWWWW
<WWWPWWWWWHNNNNNNNHWWWWWPWWW
<WWWWWWWWWWHNNNNNHWWWWWWWWWW
<WWWWWWWWWWWHNNNHWWWWWWWWWWW
<WWWWWWWWWWWWHNHWWWWWWWWWWWW
<WWWWWWWWWWWWWPWWWWWWWWWWWWW
